1
1
16
16
WWWWWWWWWWWWWWWW
WGGGGGGGGGGGGGGW
WGWGGGGGGGGGGGGW
WGGGGGGGGGGGGGGW
WGGGGGGGGGGGGGGW
WGGGGGGGGGGGGGGW
WGGGGGGGGGGGGGGW
WGGGGGGGGGGGGGGW
WGGGGGGGGGGGGGGW
WGGGGGGGGGGGGGGW
WGGGGGGGGGGGGGGW
WGGGGGGGGGGGGGGW
WGGGGGGGGGGGGGGW
WGGGGGGGGGGGGGGW
WGGGGGGGGGGGGGGW
WWWWWWWWWWWWWWWW
