1
1
16
16
WWWWWWWWWWWWWWWW
WGGGGGGGGGGWGGGW
WGGGGGGGGGGGGGGW
WGGGWGGGGGGGGGGW
WGGGGGGGGGGGGGGW
WGGGGGGGGGGGGGGW
WGGGGGGGGGGGGGGW
WGGGGGGWGGGGGGGW
WGGGGGGGGGGGGGGW
WGGGGGGGGGGGGGGW
WGGGGGGGGGGWGGGW
WGGGGGGGGGGGGGGW
WGGWGGGGGGGGGGGW
WGGGGGGGGGGGGGGW
WGGGGGGGGGGGGGGW
WWWWWWWWWWWWWWWW
