# board size
16
16

# start position
# x
1
# y
1

# ENEMIES

# number of enemies
1
# first enemy
4
1
# first enemy waypoints
#5
#5


# tiles
# W is a wall, G is ground
WWWWWWWWWWWWWWWW
WGGGGGGGGGGWGGGW
WGGGGGGGGGGGGGGW
WGGGWGGGGGGGGGGW
WGGGGGGGGGGGGGGW
WGGGGGGGGGGGGGGW
WGGGGGGGGGGGGGGW
WGGGGGGWGGGGGGGW
WGGGGGGGGGGGGGGW
WGGGGGGGGGGGGGGW
WGGGGGGGGGGWGGGW
WGGGGGGGGGGGGGGW
WGGWGGGGGGGGGGGW
WGGGGGGGGGGGGGGW
WGGGGGGGGGGGGGGW
WWWWWWWWWWWWWWWW
